zez: afn pnv uvw
zae: hku ewv ydy
qet: unr qfm
igc: jcr
vzt: dac vvp nzv
bcl: kgk kns
mgt: rxm
jnn: hgv arg
ijx: mzw
crz: vot vut kcz
hmv: sga nnn
lll: czl rdx
veg: lll ttv ymx
beu: jfq own
uli: efk
zzv: oje xpx
qpn: wag kxd
arg: qmi
elp: fqe nwv fbt
tdq: som
wci: ewv ydy
odr: kps jjp odk fsu
nej: sni yyr otm
lcr: kns wko
dtc: clh zpj
qeq: ant ong wpc
hgv: wjv kco
cqt: you
vtp: gun rwh iqr jxr
ouo: efk
mhr: hgo lyi jeh
vha: hrj osn tjh
szx: xqw
chx: okn owt sbz sve
vcl: kva wcg
dak: svg rxg
sao: hgz xhz
hbw: itr wge jef
xbd: out
rbq: qet kaz zhk fim aky xli veg sdm
faz: zba zoi
wua: tol
ejk: ijx rww
abe: bxv
tol: yqu rwu jnn rrv flx hnq cdm fns wpr lys arc pkq amt wci mgo eui zae apo rar hcp hiz kvc fdk
qwv: bme
rzf: ohe
ajb: zpj
jng: out
psa: aar mof
kck: ycc mpf xqw
vfj: dhq
nei: lif urk qwv
zba: tol pmk dkl
nfk: ggk
gsi: dkl pmk tol
okn: clh
csd: vut
snw: unr qfm wyl
qac: odr noe dpp
zhk: zrm ttk mpk
ttk: jpm wig
xsp: xey vrh yrr
wpv: tmu
hku: mfr beu spp rpw
kpr: qeq svs
nep: pmk
zed: mpf xqw
mnf: dkl tol
yrj: hvh
osn: efk sjn
myr: uqk hfp
fpq: zyb zoe cua fom oto
tuu: fwr cda
jjp: swv xym
plh: rbq clx ikn
iwe: sjn oqa
sdw: qfm sao
bph: jua nei jwk pjt
pmk: zae rrv apo rwu flx wxl kvc hcp hnq fdk fns cdm wpr lys
jei: mpf
rme: vvp dac hst nzv eva
rzn: out
khw: noo ihr rry
vot: sbv ckk vcl
yni: cqt jeh lyi hgo
gld: dmm ooh
dgf: mpf
enx: jua nei jwk pjt
hqc: efk
sqf: clx rbq roj ikn
jml: out
eeu: mzw rbq
zsq: efk
pgg: jza
kps: xym drg vzi dch
gxy: rbq mzw clx
ooh: out
arc: yqi lpt
txu: bxi aeo syu szx qyg
uyh: zyb cua
cua: emo
aka: fnh
vst: lno loj fpy
xec: xoq vzt dnz qdc
wpr: arg
sqh: dhq rww plh ijx
tgq: out
xhz: fnh mpc
wpc: mmo byr oqg
ufn: cqt lyi
clh: xlu enx bph eby wdl xxx uaa fpq jxq brt uyh dyl xzk
xzk: rje
yqu: xkf ulo
mof: oub fwb ghi udp tbe
jua: haq urk lif qlf
fta: nwf
xpx: sbz sve owt okn
khe: qeq
bsn: kxe
dgo: xqw
wge: efk
dpp: odk jjp
hha: njk ygf
sjn: kpr rtu pab diq nxk dqw
bme: vtf
hfp: snd
zoe: ewz
nzv: ksp qqv vzo scu
wju: wsh mcy
jfa: xhc
ovn: out
jeh: clh
scu: dtc
wxd: clx rbq mzw ikn
xlu: oto cua fom
anp: xey yrr
mcy: zbn
enz: ixa
wsh: iwe
sni: mpf xqw
hvx: pfu
tbe: clx rbq roj ikn
loj: rtn egw zim
zrg: vwa kgk kns akv
njk: kck inl nyb jei
vzo: ajb amx
eud: mpf xqw ycc
qqv: amx dtc ajb
oto: emo epl
ttv: czl wue
cin: yyr sni ifu
uvw: biu
pkt: efk
kxm: nzs
qys: kzk
iqr: ryc elp dru
lcm: out
yyr: ycc
vpt: sjn efk
ril: nep ezr wig
wdl: vor dcu wpv yqh
dch: out
wue: jcr ufu
nso: ijo tgq rzn
ohg: mpc faz
hde: mpf ycc
huv: aoe zez xhc rpz qbi
vrf: oqa sjn
hrj: sjn oqa efk
akv: fft jzl
kns: jkz jzl fft
brt: tdq jcb rje kxm
pfu: kxe rzf btx
jcb: nrb som nzs
aoe: uvw jbz afn
biu: dkl pmk tol
xyd: beg
zoi: pmk
itr: oqa
yjn: nic
ezm: xiy wua
vor: pgg
qyg: ycc
imv: clx mzw rbq roj ikn
duh: lcn
yom: cin ppc qxa
unr: hgz aka
xed: hbw
ufu: tol
nwf: ooh xbd
wyl: aka xhz ohg
iij: grf rwh jxr
eui: tpk exk yyc
upt: qac
xhc: afn jbz uvw
xli: zpy ttk zrm
tqp: out
odk: swv vzi dch xym
yxk: btx
iah: tmu vst pgg
ifu: ycc
lyn: yjn poi oyp myr yom mbk qnk wtp fkd nyi onw ylg vav
efi: ycc xqw
jkz: sqf jtj imv
amx: you
pnv: vnp biu
btx: pgj twu
lwf: idh mph
hst: ksp qqv scu ggo
swv: out
ocv: xhc zez rpz qbi
jza: rtn zim
urk: mgt htm
egw: pjw ovn
wiu: gld
pqa: xpx quv
lfa: vut
lpt: vpt uma
cda: ovc
ubw: mal ybz yrj
pgc: zbn pkt
rtn: kcv ovn
idg: qmi hbw dbq kco
kjr: zyb zoe oto fom
mxe: sbz
fpy: zim
hgz: faz
you: ydh mkv wdl xlu uaa fpq brt hvx aom xzk
qdc: hst
ahu: ppc cin
apo: yqi yga
agv: wol
ybz: lzv hvh eud efi
uqk: rkn gpk
oqa: krf veu khe vdi uyk mtj anp rcw nqa pin xec nxk
aky: lll ttv ymx
ppc: otm yyr
flx: jaq ibc cgz
oxz: pgj hmv
hgo: you clh
wpm: ooh dmm xbd
fqe: dkl
vjd: sjn
lcn: roj mzw
gpk: hto dgo
ghi: ikn mzw rbq clx
jwk: haq urk qlf
wcg: mzw rbq roj
hnn: zzt
kgd: gpk
wax: pgc
ydh: zui tvm oaj upt
jbu: efk sjn
nyb: ycc xqw
qph: out
nnn: lcm tqp
pci: lcn imv
mtj: khw srk dgk hsb
rwh: elp ezm ryc
zke: syu aeo szx qyg
cqs: kzk
myu: otm yyr ifu sni
efk: ywb xec pin pab dqw nxk nqa rtu uyk mtj anp diq kpr krf veu khe xsp vdi jvn rcw
hto: ycc
cai: odr dpp noe
hcp: ulo xkf
vwa: pci
rar: qpn
qga: ikn roj rbq clx
mob: lzv hvh eud efi
bhd: quv xpx mxe oje
awe: grf gun iqr rwh jxr
mal: efi hvh
fwb: clx mzw rbq roj
mwk: nso
nqa: bvt hpj
idh: zzt qga eeu
noe: jjp odk fsu
nic: bxi syu szx qyg
dbq: vrf zsq jef
emo: wiu ssf
gwf: out
zui: qac cai
jpm: tol pmk
mzb: dgo zed hto hde
jzl: sqf lcn
ebd: jgt lwf kzk
fzx: njk ixa wev nxa
rnb: rxg svg bfp
axf: sjn
zsh: out
ydy: rpw beu mfr
bvt: mhr fwr ufn yni
jvn: khw hsb dgk
fim: lll
byr: hls tbj msc
tfk: mal mob
efl: chx xpx oje quv
aar: udp ghi fwb
gwv: ejk
rrv: cgz
dcu: vst pgg
mbk: myu qxa
czl: ufu gsi
dgk: noo ihr rry qim
vnp: dkl tol pmk
kcv: out
grf: elp ryc ezm
rmj: ixa wev nxa
kxd: sjn
bxi: ycc mpf
sve: zpj you
jbz: vnp mnf biu
sbz: you
ohe: sga nnn gzm
ihr: zpj
rmt: ttv lll
oje: sbz
nrb: idn
poi: ubw tfk
djn: pmk dkl
spp: own sna
mpc: djn zoi
wtp: zke gsd
ovc: zpj
oks: rkn gpk mzb
jfq: tjh hrj jhc
hls: you zpj
fnh: zba rvo
afn: mnf
ulo: uli wag ccf ouo kxd
dbn: nso chq dzg
vtf: zsh
krf: hsb srk khw
jxq: oaj tvm upt xyd
wqo: wcg kva wxd
lno: egw zim
tng: plh ijx dhq
uaa: tdq
umc: fkd poi wtp qnk vav myr oyp ahu onw ylg
ikn: snw vtp veg ocv fim ojt zhk yjk sdw rmt huv qet awe xli cuw aky jfa mbh iij
qim: you zpj
tjh: oqa sjn
eby: eyg yxk bsn pfu
aeo: xqw ycc
xxx: zui upt xyd oaj
veu: rme vzt dnz
ezr: dkl tol pmk
mzw: iij jfa mbh aky cuw awe xli huv rmt yjk sdw fim ojt ocv kaz zhk vtp veg sdm snw
fkn: szx
ant: byr oqg
jor: vfj ejk sqh
evw: chx oje mxe
rdx: gsi ufu
jgw: mhr fwr cda ufn yni
haq: bme htm mgt
sdm: iqr
yrr: zzv
kco: vrf jef wge zsq
jcr: tol pmk
ijo: out
rry: you
cox: aar mof
zzt: roj ikn
nzs: idn mwk
eva: qqv ggo scu
ccf: efk oqa
rje: nrb nzs som
dru: fqe xiy wua
ycc: csd prl bcl sjz psa dak nfk ekw cox lcr zvt fzw
diq: tuu jgw bvt
inl: mpf xqw ycc
zpj: qdk djg enx xlu kjr uyh dyl ycv fpq jxq brt ydh mkv bph uaa
gux: gld
lif: bme mgt
sga: gwf jng vnf
ywb: srk hsb
xym: out
clx: kaz zhk fim ojt snw veg sdm vtp huv qet sdw yjk rmt cuw aky xli iij jfa
hpj: ufn yni mhr cda fwr
cuw: zez aoe qbi
mbl: out
qlf: mgt htm
nxa: dgf nyb kck
dzg: rzn tgq
wxl: gms jaq ibc
epl: fta
prl: vot vut
qxa: ifu otm
kcz: wqo sbv
cgz: ulj kzl wju
msc: you
jne: njk
ygf: jei
cek: out
tpk: hqc
dmm: out
vtv: oqa sjn
vut: ckk vcl
srk: ihr noo juw
amt: tpk exk
ekw: ggk aar mof
fzw: mof ggk
pjt: qwv qlf urk lif haq
rxg: gwv qzr
svr: lyn vgi umc
kzl: mcy wsh pgc
qbi: pnv
ful: lzv
hsb: ihr rry juw qim
ylg: nic fkn gsd txu
qdk: pfu yxk
zrm: wig ezr
tmu: loj lno fpy
ymx: igc wue
exk: jbu vjd axf
ggo: ajb xfo dtc amx
tqe: jml cek zsh mbl qph
hiz: lpt yga yqi
kaz: ril
kgk: pci jkz
lzv: ycc
qfm: xhz ohg hgz
wol: sqh ejk vfj
nxk: wvz qeq svs
fom: ewz kay emo epl
roj: jfa yjk mbh iij snw awe ojt zhk
ggk: tbe fwb
rwu: arg xed hgv idg
quv: okn owt sbz sve
fwr: ovc lyi jeh
hnq: yga yqi
ryc: fbt nwv
pao: lwf
jaq: kzl wax
ztn: hfp kgd uqk
vnf: out
vzi: out
yqi: uma vtv vpt
iqm: spp
ejb: xqw mpf ycc
nwv: tol
pkq: tpk yyc
fns: hku iqm
vrh: evw pqa zzv efl
wag: sjn
vdi: qdc vzt rme xoq
sna: jhc osn hrj
sjz: wko kgk kns vwa
udp: ikn mzw
mbh: wyl unr qfm
zbn: efk oqa sjn
jef: sjn efk oqa
rww: ikn clx mzw roj rbq
rxm: cek mbl zsh qph
oaj: qac
onw: hfp kgd uqk oks
ewz: gux fta
vjr: kcz
chq: ijo tgq
jep: hha rmj jne fzx
xey: efl evw bhd
kvc: hku
bxv: mob ful ybz mal
fsu: xym drg
ibc: kzl wax
dhq: clx roj rbq mzw
som: mwk idn dbn
xkf: ouo ccf
bfp: gwv
qzr: vfj sqh tng
drg: out
pjw: out
lys: cgz jaq ibc
own: tjh osn
wev: kck inl jei nyb
dqw: wvz
pin: jgw tuu bvt
jgt: idh hnn
vgi: ztn ffs abe poi fkd jep
zim: kcv pjw ovn
mfr: sna own vha jfq
xiy: pmk tol
rvo: tol
qnk: ubw tfk
pab: yrr xey
rkn: hde hto zed ejb
cdm: yqi lpt
rtu: vzt xoq
kxe: hmv pgj twu
cri: svg agv
lyi: clh zpj
nyi: uqk
mgo: qpn xkf
fdk: hku ewv iqm ydy
oub: ikn rbq clx
owt: zpj
jhc: efk
beg: odr
pgj: sga gzm
svg: qzr gwv jor
fft: imv sqf
mmo: tbj hls
mkv: jwk pjt
syu: ycc
mph: eeu gxy
juw: clh zpj
wig: tol
fkd: rmj enz jne
ong: mmo byr
rcw: dgk hsb khw
kay: wiu ssf
qcf: tjh osn hrj jhc
xfo: zpj clh you
ssf: nwf wpm gld
xoq: hst dac eva nzv
ixa: inl jei dgf nyb
tvm: cai beg qac
twu: nnn
zpy: jpm nep wig
mpk: wig nep jpm
ycv: zui oaj
dkl: wxl hiz hcp fdk rrv apo jnn flx mgo eui cdm wpr yqu lys wci amt pkq
oyp: zke gsd txu
oqg: tbj
kva: clx roj rbq mzw
ojt: wyl sao qfm unr
ulj: wsh
vvp: ksp scu
ckk: kva
zvt: akv
qmi: itr
yga: vtv uma
mpf: ebd cox nfk csd vjr lfa cqs zvt crz
dnz: nzv vvp
uyk: qeq
yyc: hqc ujj axf
svs: ant wpc
sbv: wxd wcg
yjk: zpy mpk ril zrm
ujj: oqa
zyb: emo kay epl
ewv: rpw
eyg: rzf oxz kxe
otm: ycc xqw
yqh: tmu
gzm: jng tqp vnf
fbt: pmk dkl
snd: ejb hde
jtj: clx rbq roj mzw
aom: iah yqh wpv
ksp: dtc
kzk: mph
uma: efk oqa
djg: vor iah
htm: rxm vtf tqe
wko: duh
dyl: dcu yqh iah
wvz: ant wpc
noo: you clh
dac: vzo ggo scu ksp qqv
rpw: vha jfq qcf
ffs: jne fzx rmj hha enz
gsd: bxi szx syu aeo
vav: nej
ehw: kzk lwf jgt
gun: ezm
jxr: dru
xqw: bcl pao prl ebd sjz csd psa dak qys cri rnb cox ekw vjr cqs zrg lcr ehw crz fzw zvt
gms: wax wju
idn: dzg
wjv: zsq
tbj: you clh
rpz: uvw afn jbz
hvh: mpf xqw
